# ## # g ######
# ##   # #     
#  #  ## # ### 
## ## #  ##### 
##    # ##   # 
#  ###  ## # # 
## #   ##  # # 
#  # #   ### # 
## #   ##      
#  ## #  ### ##
      ## ##   #
#####    ## ###
    ###  ##   #
### #   #### ##
##        m  ##