#    # g ###  #
# ##   # #   ##
# #  ### ## # #
# ##     ## # #
  #  #####  # #
 #  #   ## #   
 # #  ##   ### 
 # # #   ### # 
 # #   ###   # 
 # ## #   ## # 
 #    # ##   # 
 ####    # ### 
   ####  #     
## ##   #### ##
##        m  ##